111111
100001
1P0011
1C11E1
111111
