11111111
10000001
1P000001
10C00001
11111101
11111101
1000E001
11111101