1111111
1P000C1
1001101
1C001E1
1000001
1111111
