111111111
100000001
1C0000001
1000000E1
111111111
