1111111111111111111111
1000000000000000000001
1P00000000000000000001
10C0000000000000000001
1111110000000000000001
1111110000000000000001
1000E00000000000000001
1111111111111111111111