1111111
1PCCCC1
1CCCCC1
1CCCCE1
1111111