1111111
1P000E1
1C0C0C1
1111111
