111111
1101P1
1101C1
1101E1
111111
111111